11111111111111111
10000000C100000E1
10000100010010001
10100100000011111
1C100100P0001C001
10100000000010001
1011000C000010001
1C00000C0000000C1
11111111111111111