1111111111111111111111111111111111
100000000000001C00000C000000000101
1111011100100001101001000000010111
1010010010101010001001000000010111
1P0000000C00C0000000010000000000C1
1000000000000000000000000000000001
1000000000000000000000000000000001
1E0000000000001C00000C000000000101
1111011100100001101001000000010111
1010010010101010001001000000010111
100000000C00C0000000010000000000C1
1111111111111111111111111111111111