11111111111111111111111111111111111111111111111111111111111111111111
100000000000001C00000C000000000101100000000000001C00000C000000000101
11110111001000011010010000000101111111011100100001101001000000010111
10100100101010100010010000000101111010010010101010001001000000010111
1P0000000C00C0000000010000000000C1100000000C00C0000000010000000000C1
10000000000C000000000000000000000000000000000C0000000000000000000001
1E0000000000001C00000C000000000101100000000000001C00000C000000000101
11110111001000011010010000000101111111011100100001101001000000010111
10100100101010100010010000000101111010010010101010001001000000010111
100000000C00C0000000010000000000C1100000000C00C0000000010000000000C1
11111111111111111111111111111111111111111111111111111111111111111111