1111111111111111111111111111111111
100000000000001C00000C000000000101
1111011100100001101001000010010111
1010010010101010000101C00010010111
1P0001000C00C0011101011111100000C1
10000011100C0001E10101001100000001
100000000000001100010C000100000101
1111011100100001111001000110010111
1C10010010101010001001000100010111
100000000C00C0000000010000000000C1
1111111111111111111111111111111111