111111111111111111111111111111111
10000000000001C00000C000000000101
111101110010001101001000010010111
101001001010000000101C00010010111
1P0001000C00C011101011111100000C1
10000011100C001E10101001100000001
10000000000001100010C000100000101
111101110010001111001000110010111
1C0001001010110001001000100010111
111111111111111111111111111111111