11111111111111111111111111111
1E0000000000001C00000C0000101
11110111001000011010010010111
10100100101010100010010010101
1P0000000C00C00000000100000C1
11111111111111111111111111111